Słownik Polsko-Installingowy

autostopowicz - Anhalter
brązowy  medal - Bronzemedaille
chcemy - wollen
chorwacja - Kroatiens
droga rowerowa - Radwege
gra strategiczna - Strategiespiel
ilość, masa, tłum - Menge
ipod - iPod
jeździć konno - reiten
kibicować - anfeuern
kierunek jazdy - Fahrtrichtung
kort tenisowy - Tennisplatz
kosmetyki - Kosmetika
mistrzostwa - Meisterschaften
morze bałtyckie - Ostsee
motocykl - Motorrad
motorower - Mofa
możemy - können
musimy - müssen
narta - Ski
odbywać się - stattfinden
ogólnie, w sumie - insgesamt
orchidea - Orchideen
pierwszeństwo - Vorrang
piłka - Ball
pociąg - Zug
poczta - Post
powinniśmy - sollen
pralina - Pralinen
prosto - geradeaus
przejście dla pieszych - Fußgängerüberweg
pływać - schwimmen
rakieta tenisowa - Tennisschläger
ratusz - Rathaus
rezultat - Ergebnisse
rower - Fahrrad
roślina pokojowa - Zimmerpflanzen
salon gier - Spielothek
skasować bilet - entwerten
skrzyżowanie - Kreuzung
smakołyk - Leckerei
spodenki kąpielowe - Badehose
statek - Schiff
styl życia - Lebensstil
szwecja - Schwedens
tenis - Tennis
tor do jazdy konnej - Reitbahn
uczestniczyć - teilnehmen
ustanawiać rekord - aufstellen
współuczestniczyć - mitmachen
wyścig - Wettrennen
włochy - Italien
zakaz jazdy - Fahrverbot
zakaz parkowania - Parkverbot
zdmuchiwać - auspusten
złoty medal - Goldmedaille
ławka - Bank
łyżwa - Schlittschuh
świeca - Kerze
świętować, obchodzić - feiern